##### 
#.  ##
#@$$ #
##   #
 ##  #
  ##.#
   ###